Og det kan blive svært, hvis udlændinge både skal regne med at betale den høje, danske skat og samtidig at få ekstraudgifter til lægebesøg eller skolegang for deres børn.	negativ
Antalya, Tyrkiet - Billig leje af bil I samarbejde med Cartrawler kan vi herunder tilbyde dig den billigste pris på Antalya, Tyrkiet - Billig leje af bil.	positiv
" 40 børn løb og leg med Øens hold-karavanen, ved den sidste træning før sommerferien den 22. juni 2011.	neutral
Anerne er i øjeblikket kun ført tilbage til midten af 1800 tallet, men det vil uden tvivl være muligt at finde længere tilbage.	neutral
Anbefales til alle der har interesse indenfor det Japanske Sværd.	positiv
Analyse: Bortset fra 10 minutter var Aarhus Fremad totalt spilstyrende mod et tamt Viby-hold.	neutral
Christrup, der flytter til landsdelen om kort tid, har tidligere fungeret i store københavnske forstadsklubber som Solrød og Ishøj samt været landstræner i Grønland, arbejder til daglig som konsulent i Danmarks Badminton Forbund.	neutral
Alternativ 2, Jernbanebro over bane: Der anlægges en enkeltsporet jernbanebro over Øresundsbanen mellem Amager Landevej og Øresundsbanens underføring under Øresundsmotorvejen.	neutral
Again Wash - Masseres ind i hår og hovedbund efter hårvask, lad virke i 2-10 min.	neutral
Allerede den 18. februar 2012 citeres du i Aarhus Stiftstidende for følgende: "Elevtallet på Ørum Skole er pustet op til et kunstigt højt niveau.	negativ
14. november lancerede H&M deres kollektion skabt i samarbejde med selveste Isabel Marant.	positiv
9 produkter produkt Kr 891,00 (tom) Drikker du for mange øl?	neutral
Aliquid posse, non necesse utile Titel: Re: Sv: kniv til alm outdoor aktivitet,men hvilken model anb : torsdag, 07. marts 2013 20:54 Der er 2 tuber autosol for 60 kr hos T Hansen pt.	neutral
En dag i maj sidste år kommer vognmanden med et forslag: De unge kan få en nøgle til garagen, så de kan bruge den, når de har lyst.	positiv
Af Calvins Lære kan man udlede både en intens Individualisme og en barsk kristelig Socialisme.	neutral
8. november 2013 kl. 10:29 Meget inspirerende og hvor er det dog sejt at du faktisk er selvlært og hvor er det bare modigt, at rive det hele op og flytte!	positiv
Angiv afrejselufthavn (land/by): flyrejser fra København til Elat, Ovula flyrejser fra Tirstrup til Elat, Ovula flyrejser fra Billund til Elat, Ovula Hvis Deres Afgangslufthavn ikke er på listen benyttes søgeboksen ovenfor.	neutral
Afrunding og spørgsmål.	neutral
Afsnit I Betydningen af opstandelse Ordet opstandelse" betyder at gå fra en død tilstand over til en levende tilstand.	neutral
Andre selskaber flyver fra Suvarnabhumi lufthavn.	neutral
Anmeldelse: Legen og intelligenserne - i SFO'en I bogen ”Legen og intelligenserne – i SFO’en” har Jørn Martin og Lotte, sammen med SFO pædagogerne fra 9 skoler, samlet en række interessante lege for børn i 5 til 10 års alderen.	positiv
Han anlægger sine steder med tilbageblik på sin egen barndom en åben og tilnærmelsesvist naiv tone, der på en og samme tid udstiller og afspejler delegationens mangel på kritisk blik på det, de tror, er et skridt på vejen i realiseringen af deres utopi.	negativ
»Jeg advarede amerikanerne og den irakiske regering om, at hvis de bliver ved med at forsømme at give os løn, vil Vækkelsesrådets medlemmer blive stadig mere desperate og lede efter andre måder at tjene peng på,« siger han.	negativ
Foto: Claus Beyer Publiceret: 22. Juli 2010 07:00 Landbetjente måtte trække pebersprayen Landbetjentene i Hammel var forleden nødt til at pacificere en 62-årig mand med peberspray, da han optrådte truende overfor en kommunal..	negativ
"Aarhus er landets næststørste by, og jeg ser store vækstmuligheder både i Aarhus og resten af den østjyske region.	positiv
Arbejdet skulle gerne sættes i gang hurtigst muligt, og Vilhelm Østergaard vil straks tage fat derpå.	neutral
Anyway, hvis du virkelig er fuldt og helt overbevist om at olien snart slipper op, så kan jeg gøre dig til millionær.	neutral
Al den information der sendes via disse celler, igennem synsnerven til hjernens visuelle cortex hvor den afkodes, er kun undervejs i få picosekunder.	neutral
Ad 1. De øvrige byggerier i området, uanset at man bestemt kan diskutere kvalitet m.m., har været med til påvirke et faldende prisniveau.	neutral
Angst er et hyppigt symptom på en række psykiske lidelser, blandt andet depression.	neutral
Aarhus Teater lover med ‘Sweeney Todd’ en ‘musical i verdensklasse’, men showet, som vist har været lidt for mange gange gennem kødhakkeren – træder først rigtig i karakter i anden akt.	positiv
4) Interventionen skal være tilstrækkelig holdbar i forhold til gældende international ret - den kan være i "konflikt" med den, men kun i en vis udstrækning og kun hvis man kan påberåbe sig en særlig nødsituation.	neutral
3. Læring i samspil med andre 6. At arbejde i og med fællesskaber 7. Modeller der kan støtte elevens læreproces 9. Hvordan kan man komme igang?	neutral
29. november 2011 kl. 12:37 Osse mig osse mig – elsker spil.	positiv
Anders Høgrbro Madsen) Spørgeskema om tilfredshed vedr. foredraget “Hvad er reel inklusion?”	neutral
Der kan kun linkes til informationsudbydere som har sider med informationer der har relevans for Aars-området.	negativ
De havde skrevne love svarende til vore landskabslove.	neutral
Alt for længe er vi blevet udsat for et uvirkeligt og umenneskeligt show i Tour de France.	negativ
Ændringsforslag til indkomne forslag kan fremsættes på generalforsamlingen.	neutral
Al vores erfaring og talrige videnskabelige undersøgelser viser, at det ikke alene kan lade sig gøre at behandle OCD effektivt med kognitiv adfærdsterapi, men at det også er den mest effektive form for behandling.	positiv
Ansøgningsskema kan afhentes i butikken fra slutningen af oktober, ligesom du kan søge online på vores hjemmeside.	neutral
Ærgerligt at det er så tissekoldt, at ingen kommer til at se det.	negativ
Alt er at vinde og du vil blive til en anden.	positiv
Abonnementstegning og betaling kan også finde sted i Portalens billetudsalg.	neutral
Antispin-belægninger kan, når de benyttes rigtigt, give bolden et svæv, som gør bolden svær at læse for modstanderen.	positiv
2. Materialet akklimatiseres i lokalet ét døgn før anvendelse. 3. Undergulvet skal være tørt, fast og jævnt, jvf.	neutral
1. Mentalt udviklingsspring 9 2. Mentalt udviklingsspring 6 3. Mentalt udviklingsspring 2 4. Mentalt udviklingsspring 10 Lad os sende dig en besked med vores e-springvækkeur, hver gang dit barn er ved at gennemgå et spring i sin mentale udvikling.	neutral
4) Omgivelserne og det sociale liv i parcelhuskvarterer vægtes højere.	positiv
2. Stærke kvinder Poledance er blevet populært i fitnesskredse læs mere..	positiv
Måske det bare skulle være en tøjhund..	neutral
Ankestyrelsen hjemviste derfor sagen til kommunen til fornyet behandling og afgørelse, således at kommunen skulle træffe afgørelse efter § 55, stk. 1 overfor forældremyndighedens indehaver.	neutral
Her får vi frokost med børnene, vi spiller basketball med dem og deler historier.	neutral
'10-20-30' slår hurtigt positivt ud på formkurven, det er mere afvekslende, og mange vil se positivt på, at det hurtigt er overstået.	positiv
Antallet af fortsatte ledige, der er en uge forsinket i forholdt til nytilmeldte ledige, faldt til 3,340 mio. fra 3,381 mio. Der var ventet et niveau for fortsatte ledige på 3,350 mio. i forrige uge.	positiv
Alt i alt nogle perspektiver der sammen med de nye supersygehuse til 40 mia. kr. tegner meget lovende.”	positiv
Andre figurer i filmen lider under, at der stadig ikke har været plads til at fortælle hele bogens historie, men i sidste ende er det til at leve med.	neutral
13. september 2012 at 20:18 Skriv et svar til Ida / Fashionlab Annuller svar Velkommen til!	neutral
11. Dette tilbud er gældende for danske kunder.	neutral
Arbejdet med analyserne er forankret i fagudvalgene efter den proces, som er skitseret i budgetlægningsprocessen.	neutral
3. Forebyggelse – hvad fører til stress, og hvordan kan man undgå, at stress opstår?	neutral
A. D. Jørgensen: Sognetallet i Jylland i middelalderen. 6, II, 634-643.	neutral
Publiceret: 14. Maj 2010 10:00 Håndbold: Fra håndholdt til håndbold Med en massiv succesoplevelse in mente i form af en overbevisende udesejr på 26-20 over naboerne fra Furesø Håndbold var det ventet, at BHK's opgør..	positiv
Alt Til Kager TAGER Altid Udgangspunkt i dag-til-dag levering.	neutral
Afskalning og sortering Inden kaffebønner bliver eksporteret, skal de afskalles og sorteres.	neutral
Af Lars Buch Jensen G 01.0 Ledelse af akademiske medarbejdere i praksis.	positiv
Åbningstid udvidet pr. 1.5.	neutral
Altså foregår hele dit læringsforløb som en kombination af skoleforløb, praktisk forløb og ekstra kurser på enten skolen eller hos Kopenhagen Fur i Glostrup.	neutral
Anders Bendtholm og Tobias Emdal spillede en god kamp i centerforsvaret. 37 u13 piger trænede i højt humør.	positiv
Åh jeg kommer snart, pustede hendes mand og satte tempoet op.	positiv
Alle billeder tilhører VisitDenmark Du skal være logget ind for at skrive en kommentar.	neutral
Alle usikkerheder til trods, ser det dog klart ud til, at der har været flere eftersøgninger i bukkejagten 2005 end tidligere.	neutral
1,09 1/2 rupi på luftpostbrev fra Calcutta, Indien, d. 14.8.1942 til New York, USA.	neutral
19. marts 2013 at 18:28 Må jeg høre hvorfor du ikke vil bruge et israelsk produkt?	negativ
2. Fyld: Skræl æblerne, og skær i mindre stykker.	neutral
Ad pkt. 2. Godkendelse af referat.	neutral
Uddannelseschef for Frisør og service, Mie Poulsen, håber at den såkaldte praktikpladspræmie vil skabe flere lærepladser.	positiv
Det viser sig nu, at det kan have forurenet grundvandet.	negativ
Helle og Villy står stærkt sammen, og i enhver partileder debat tror jeg, at de ville kunne jorde Lars Løkke både retorisk men også på det værdimæssige.	positiv
1848: Frederik den 7. konge.	neutral
Ansøgningen skal bl.a. indeholde beskrivelse af udestuen, nøjagtige tegninger, materialer, placering, afstand til skel og bebyggelsesprocent på grunden.	neutral
Al den plads, der er i sindet til alting, synes uendelig.	neutral
1) Bearnaise er sådan lidt for tykt og "klamt" til det, synes jeg.	negativ
Ægteskabet holdt desværre kun i 12 år, men jeg blev gift med en anden svensker, Per Rydén, som jeg derefter fulgte rundt i verden.	neutral
Advokat og partner i Brandt & Lauritzen, Jon Lauritzen, er blevet beskikket som bisidder i forbindelse med Skattesagskommissionen.	neutral
Publiceret: 06. December 2010 11:05 Se billeder: Varm kaffe til kolde passagerer Bevæbnet med kaffe i rygsækken gik Aarhus Sporvejes chauffører i dag på gaden og delte morgenkaffe og eftermiddagskaffe ud til passagererne.	positiv
Nu har den lokale bestyrelse sat navn på yderligere ni kandidater, der på listen opstilles sideordnet i alfabetisk rækkefølge.	neutral
Alle listede sider bør være om "skov" - hvis ikke, så må du meget gerne informere os.	neutral
Alfa-Omega har mere end 15 års erfaring inden for laboratorieindretning.	neutral
Apple i Australien: Få pengene for ny iPad tilbage I Australien tilbyder Apple, efter krav fra myndighederne, at ejere af den nye iPad, kan få pengene tilbage, hvis de føler sig vildledt af Apples 4G-markedsføring.	negativ
7. februar 2013FM 2013 - 3. runde bød på artige overraskelser De første to runder ved FM 2013 bød ikke på de helt store overraskelser, men det blev der i den grad lavet om på i 3. runde, hvor de nærmest stod i kø.	positiv
23. oktober 2010 kl. 20:01 Det er lige mine tanker du rammer med dette indlæg.	positiv
På BBC fik han også sit eget danserprogram, som idol for den ny tids helt: Den metroseksuelle mand.	neutral
Afhængigt af motoren leverer Audi to forskellige gearkassetyper: Den trinløse multitronic sender kraften til forhjulene, mens den sportslige 7-trins S tronic arbejder sammen med det permanente firehjulstræk quattro.	neutral
24. august 2013 d. 15:27 - (0) Håber jeg kan være den heldige.	positiv
Af mel og fedtstof laves en afbagning der spædesmed suppe.	neutral
Af studieordningen fremgår det, at formålet med bachelorprojektet er, at du lærer selvstændigt at formulere, afgrænse og analysere en udvalgt sociologisk problematik.	neutral
Alle er velkomne til at deltage, selv om de ikke er forhåndstilmeldt, men må i så fald selv sørge for kørsel, færgebillet og overnatning.	neutral
ADD kunne derved ikke teste ham.	neutral
! 2. aug 2010 kl. 14:32 LOL kig nu på billedet og læs alt teksten, og så er den faktisk ret logisk!	positiv
”Alle ved, hvor irriterende det er at sidde i kø på grund af vejarbejde, og vores basismodeller kan anvise effektive og praktiske løsninger til en række forhold.	positiv
Med nyhedsbrevet er du sikker på hele tiden at være orienteret om, hvad der sker i avisens udgivelsesområde, Hørsholm og Fredensborg kommuner.	positiv
Aarhus Kommune vil derfor begrænse antallet af birketræer i det offentlige rum.	neutral
54. Denne tjekliste har sekretariatet til hensigt at anvende for at få et førstehåndsindtryk af, om et givet netselskabs anmeldte IO-årsberetning overholder de grundlæggende krav fra overvågningsbekendtgørelsen.	neutral
Ansigtstoneren indeholder ekstrakter af tang (Fucus vesiculosus og Chondrus crispus) og planter (ginkgo biloba, purpursolhat, troldnød), og er beriget med antioxidanter (vitamin C og E).	neutral
986 Birgitte Nielsdatter i Tvingstrup. 30.1.1781, side 514.	neutral
3. “Bibliotek og Viden” - for meget bibliotek og for lidt viden?	negativ
9220 af 15/12 1999: Ankestyrelsens principafgørelse C-17-99 om begrundelse - hjælp til nødvendige praktiske opgaver i hjemmet - hjemmehjælp - kvalitetsstandarder - visitationskriterier - ulovlige kriterier - konkret individuel vurdering - skriftlighed.	neutral
2. Hvert land eller territorium anvender i sin samhandel med Medlemsstaterne og de øvrige lande og territorier samme regler, som det anvender over for den europæiske Stat, med hvilken det opretholder særlige forbindelser.	neutral
Almindelige åbne lommer, hvor man bare har fjernet elastikken, er ikke særlig godt IMO.	negativ
10. Apr. 2013 kl. 20:36 Både Socialdemokraternes og statsminister HelleThornings hjemmesider er gået i sort efter hackerangreb.	negativ
Altså en reel mulighed for at lægge til, også i flere dage.	neutral
Alle partoutbilletter er inkl. camp – festivalcampen åbner tirsdag d. 29. jul 2014.	neutral
5.Valg til bestyrelse, suppleanter, bilagskontrollant og bilagskontrollantsuppleant.	neutral
De arbejdere, der deltog i oprydningen, fik ikke at vide, at de risikerede at blive udsat for radioaktiv bestråling.	negativ
Til sidst kommer den ind på arbejdsløshed.	negativ
Af ÆrligeBente Jeg har et lidt halvmakabert arbejde.	negativ
Alt for at din rejse til Mount Wilson skal blive en så god oplevelse som muligt.	positiv
17:25 Briterne skummer af raseri over, at bankdirektører fortsat forgyldes med bonusser, mens landet driver mod recession.	negativ
100% økologisk rå naturlig bomuld, som efterfølgende er blevet indfarvet med naturfarver.	neutral
½ time og pensl dem derefter med et sammenpisket æg eller kaffe.	neutral
Afsnit 5 konkluderer med at foreslå en ny alternativ didaktisk model, PANEL (A Pedagogic-Didactic Approach to Design of Netbased CSCL) og redegør for dens kvaliteter sammenligning med et traditionelt didaktisk design.	neutral
126. Tina Fischer/Mad i farver 2. november 2013 kl. 16:17 Alle farver er ret lækre, men jade må være min favorit.	positiv
Ad pkt. 9 Valg af suppleanter.	neutral
Afgasningen kan først og fremmest lugtes, men ikke sjældent kan luften indendørs ligefrem føles stikkende i øjne og næse.	negativ
Ammefunktionen er helt genial, lynlåse går ind fra hver sidesøm og understøtter kjolens enkle design som en slags raglan og ingen kan se, at der rent faktisk er lynlåse i syningerne.	positiv
Anders S Hansen.	neutral
10-06-2010 Forslag til sportsudvalg. 06-06-2010 BMCK var til Open by night. 06-06-2010 Resultater fra klubmesterskab på MyLaps.	neutral
Alligevel konkluderer to af St.	neutral
17. Kb1 bxa3 med sort fordel".	positiv
Den nye tegnefilmudgave har samtidig givet Splint og Kvik mange nye fans.	positiv
Alle de situationer var ikke opstået, hvis dommeren havde været mindre large i starten af kampen.	negativ
Anonym16. aug. 2013 kl. 21.10 Jeg vil anbefale varmluftsovn, det tørrer ligesom bedre til marengs.	positiv
Andelen af ikke-brugere svinger mellem 15 % og 27 %.	neutral
Det var bandeenheden ved Københavns Politi, der selv tog sig af aktionen, selvom Ishøj strengt taget hører ind under Vestegnens Politi.	neutral
Afrikanere har altid været vant til at hjælpe hinanden og være taknemmelige for hvad de har.	positiv
20-årige Levi Johnston blev for to år siden far til en datter med Bristol Palin uden, at parret var gift.	neutral
Antallet af ledige, der bliver sendt i virksomhedspraktik eksploderer i år, fordi regeringen har ændret på refusionsreglerne.	neutral
235,-Vedel, Anders Sørensen.	neutral
Altså jeg syntes du skal gøre dig nogle alvorlige overvejelser om du vil skubbe alle os, der tilfældigvis er mænd, ind i kategorien "fjender" i denne kamp.	negativ
Analyseværktøjet giver mulighed for en enkel webbaseret adgang til kunder og netværk, således at markedsdata kan indhentes uden væsentlige omkostninger.	positiv
Alle bliver de forbedret kraftigt med professionel software.	positiv
"BUO har i mange år lavet meget besøgte matineér i Baltoppen og skam også spillet på Skovgaarden og i Satellitten.	positiv
Alligevel meget magt takket være i5 processor.	positiv
28. Hvorledes kan I afvise at tro på Gud, når I (dog) var uden liv, og Han gav jer liv?	neutral
3 Hvilket land stammer shibaen oprindelig fra?	neutral
5 Vi har en vifte af tilbud som skal hjælpe unge LGBT-personer i deres hverdag. 6 Vi gør oprør – og gør en forskel i verden.	positiv
5. 10.000 børn synger med på 'Fødderne Viser Vej'	neutral
Alternativt kan ansøgningen sendes pr. post til: Dansk Landskabsarkitektforening Det forventes at modtagerne af legatet udfærdiger en kort rapport eller rejsebeskrivelse.	neutral
10. maj 2013 d. 12:01 - (0) Den er så skøn den stol.	positiv
De får fem procent mere indflydelse fra 2011.	positiv
Andelen af små virksomheder er inden for fiskeri inklusive hav- og dambrug på tilsvarende niveau.	neutral
Overvågning, tjah, jeg ved ikke om det kan kaldes liberalt at gå ind for mere overvågning.	negativ
I Nordjylland er der nu en tilsvarende situation.	neutral
Men vi begynder ikke ved ingenting, vi begynder med, at der har været lønfest på direktionsgangen, og nu er det vores tur.	negativ
Arbejdet med omlægningen af fjernvarmerør i Albertslund Syd er i gang.	neutral
Anbefalinger af legeakademiet.dk Forside - Legetøj 2-4 år - Natur & Udeleg - Aktivitetskegler Tilføj produktet til din ønskeliste Stak disse fine plast kegle og kom udenfor i det gode vejr.	positiv
Al Dair kom til skade i hegnet som 2 års, og er derfor ikke, som planlagt, blevet sat i galoptræning.	negativ
Publiceret: 23. Marts 2010 06:00 Kvinde kørte mand ned og flygtede En 70-årig mand fra Ganløse ligger lige nu på Rigshospitalets traumecenter, hvor hans tilstand er særdeles kritisk men stabil.	negativ
Alligevel spiller han fodbold.	neutral
4. Tolkning: Sæt din undersøgelse af motiv, symbol og tema i forhold til din karakteristik af personer, sprog og handlingsforløb.	neutral
Foto: Morten Timm Publiceret: 24. August 2010 08:30 Kvinde kørte mand ned og flygtede En 70-årig mand fra Ganløse ligger lige nu på Rigshospitalets traumecenter, hvor hans tilstand er særdeles kritisk men stabil.	negativ
Ærgerligt, at nogle personer ikke forstår at vise andre det nødvendige hensyn, i sociale medier på nettet.	negativ
Almindelige medlemmer nyder de samme fordele som faste medlemmer, så længe de har klip til rådighed.	positiv
Arbejderen har spurgt ministeren, hvorvidt han vil lytte til de kritikpunkter, som KL og Dansk Socialrådgiverforening rejser.	negativ
Det er dejligt især når vi holder vinterferie, så er der nemlig tid til at bygge snemand.	positiv
Den gennemsnitlige indkomst skal stige med 6,6 procent, blandt andet ved at skabe 45 millioner nye arbejdspladser i byerne.	neutral
A?" ( eller hvad selskabet nu hedder i denne uge ) pynter, efter min mening, ikke på området som helhed.	negativ
Accept-Ranges: none Date: Thu, 10 Apr 2014 18:59:31 GMT Connection: close Content-Length: 13828 Klik her hvis du ikke kan se nyhedsbrevet Velkommen til tredje udgave af Kammeradvokatens nyhedsbrev om insolvensret.	neutral
A. Forklar hvad der skal laves.	neutral
Skøn- og faglitteratur (1) Alle annoncer (1) Kun forhandlere (0) har 1 flyttekasse med kærlighedsromaner, gigant, harelquin osv sælges samlet..	neutral
Er det ikke nødvendigt at skifte ud i partitoppen, hvis du skal nå de mål?	negativ
Anvendelser Jern er med 95% af tonnagen det metal, der bruges mest i Verden.	neutral
Afgrænsningen mellem farverne er ikke skarp nok i de lodrette skift.	negativ
Apotekerne tjener masser af penge, fordi der ikke er konkurrence, ja sådan mener konkurrencerådet.	negativ
Åbningen er med det bestående personale, hvorfor der må påregnes en eventuel ekstra belastning i f.m. de svageste udfra kommende brugere.	negativ
21:43Josep Guardiola vil ikke kalde det nuværende Barcelona-mandskab for verdens bedste fodboldhold i historien.	negativ
Analytiske bestanddele: Bozita Bidder i Sovs 1 x 370 g Mine katte elsker deres daglige Bozita og ingredienserne er fine.	positiv
Arbejder med et bredt felt af opgaver inden for fysisk planlægning, dog med hovedvægt på lokalplanlægning.	neutral
Mange af dem føler, at deres skamlæber er for store,« siger han.	negativ
Aflastningsforanstaltninger uden for hjemmet, f.eks. hos aflastningsfamilie eller aflastningsinstiution, kan blive nødvendig.	negativ
5. Amdi Petersens Armé: ’Amdi Petersens Armé’ – jeg glemte lidt at høre dansk musik i år, og derfor må jeg snyde og inddrage en opsamlings-lp, selvom det er imod reglerne.	neutral
10:13 am on november 24, 2012 Tak!	positiv
8. Sluk for pladen og tag gryden væk fra varmen.	neutral
Lilibeth laver performances om at være kvinde og ikke-etnisk dansker.	neutral
Alle, der laver telte, gør det på gulvet, og der er ikke mulighed for at rulle materialet hen over et apparatur.	neutral
Aftal på forhånd hvilke lyde, der skal trænes.	neutral
Andet kan være det, som du køber til og i virksomheden.	neutral
5. Den næste elev sættes i gang.	neutral
Anses af de kristne som Guds søn og verdens frelser.	positiv
Af de ting, du kan ændre på, skal du udvælge en enkelt ting ad gangen, som du fokuserer på.	neutral
26. Maiken 16. juni 2010 kl. 21:48 god ferie – vi venter med spænding på “postkort” i starten af august 27. Louise Klinge Nielsen 16. juni 2010 kl. 22:49 Ja, god ferie og tænke-tanker-tid.	positiv
Og med arrangørernes ønske om konstant udvikling og fornyelse, er Ebeats nu klar til at rykke ind i de historiske lokaler i Kongensgade.	positiv
Publiceret: 05. Juli 2010 15:26 Larsen lægger MusikTeatret ned Der skal nok blive fest i salen, når Kim Larsen & Kjukken 17. februar kl. 20 fyrer op under publikum til en udsolgt koncert i MusikTeatret.	positiv
Andre steder havde man da lavet sig en gang is med stout og så var den fisk vidst da også skællet.	neutral
Den nye færge har kostet 33,5 mio. Den bliver indviet lørdag og vil sejle i pendulfart til september.	positiv
Alle hold har deres “trademark-formationer”, som de benytter igen og igen, fordi de enten virker – eller HAR virket tidligere.	neutral
Af en helt anden art er som sagt de tilfælde, hvor ordspillet ikke er hovedsagen, men kun et middel til at udtrykke en tanke i ord, som let huskes.	neutral
Af alle grimme fodboldtrøjer, vil mange nok mene at det her er en klar vinder.	neutral
Pengene gik blandt andet til efterårsturné samme år i Holland og Belgien, og de sidste mønter er så gået til indspilningen af ep?en "Sit Down By The Fire", som guitaristen Aske Zidore fra Oh No Ono har mikset.	neutral
34 kommentarer Everything Se indlæg isabellathordsen I sidste uge købte jeg disse fantastiske solbriller og denne smukke smukke russiske ring.	positiv
3. Hvis du printer din aflevering skal hver side have et sidehoved, der indeholde samme informationer som skolens papir.	neutral
30. juli 1746 - copuleret Christian Møller af Gjesinggaard mølle og Anne Pedersdatter af Hjørnekær mølle, som tilforn Dom 2 p. Pasch 1746 (24. april 1746) var blevet trolovet.	neutral
· Alle lejlighederne har køkkenniche med 2-4 kogeplader, køleskab, miniovn og opvaskemaskine ( i de fleste af lejlighederne ), badeværelse med kar, toilet, balkon ( i de fleste af lejlighederne ).	neutral
Alene i Region Nordjylland har der i de sidste to uger af 2010 og frem til begyndelsen af denne uge været påvist 26 positive influenza H1N1-prøver hos praktiserende læger og på sygehuse.	negativ
Alder er ikke indgået som kriterium.	neutral
31-årige Totti stod for begge mål.	positiv
Alt det lækre hundetilbehør som man finder hos Cotonshoppen finder man til alle slags hunde, så om det er en lille terri eller en stor rottweiler du har så finder man hundetilbehør der passer til dens størrelse.	positiv
1 værelse med 1 Enkelt seng, 1 Enkelt seng, 1 Briks, 3 sovepladser i alt Tilføj til favoritter Fjern fra favoritter Sæsonkalender Se hvornår huset er ledigt 3 uger for 2 ugers pris i lavsæsonen. 14 dage for 10 dages pris i lavsæsonen.	neutral
2. plads i CEI2*/120km i Göingeritten på Victor de Chamant i 2013.	neutral
Sir Salman Rushdie (født 19. juni 1947 i Bombay, Indien) er en forfatter af fiktion, hovedsagelig foregående på det indiske kontinent.	neutral
Jack Straw begrunder kravet med at det i modsat fald kunne føre til 'strategisk fiasko'.	negativ
Et af de mere bemærkelsesværdige projekter er 'Flydende by', som skal sætte fokus på klimaproblemerne.	positiv
Alt hvad der har med vores ækle krop at gøre er fy.	negativ
1997 (2 ansøg- ninger)	neutral
Anne Dorthe Tanderup fortæller med velkendt kampg­ejst, smittende overb­evisning og helt almin­delig bonde­fornuft om de tanker og erfar­inger de.	positiv
Accepterer den dybtliggende menneskelige følelse at en krænkelse skal besvares med en afpasset mod-krænkelse.	neutral
Afstanden mellem pyramiderne er forholdsvis stor, især den mindre Mykeriospyramide ligger lidt afsides.	neutral
2. bestigningen af Koalakanten samme dag som Martin Tomlinson fandt og gjorde den.	neutral
Af: Kristoffer Dahy Ernst, 28. september 2012 De seneste år har det nærmest ikke været muligt at bestille bord på en restaurant uden samtidig også være tvunget til en bearnaise-storm uden lige.	negativ
1. I led 1 og 2 efterlades strået stående efter ribbehøst og med høj stub efter høst med mejetærsker.	neutral
Manden kom kørende ad Strandvejen i Gedser, da han i krydset ved Strandvejen og Gedser Landevej væltede og pådrog sig åbent kraniebrud.	negativ
Af FlemmingLeer den 29. november 2012 - 13:27 Permalink Simon fra Folketingssekretariatet har lavet en opgørelse over alle de forlig, som Enhedslisten er med i finanlov 2013.	neutral
Accept-Ranges: bytes Last-Modified: Mon, 18 Feb 2013 20:04:25 GMT ETag: "8648ce2613ece1:9f5" Content-Length: 14873 Her på siden kan du se hvad Allan og jeg tipper til weekenden.	neutral
Alting bør gøres så enkelt som muligt, men heller ikke enklere - Albert Einstein Jeg åbner lige denne tråd igen.	neutral
Anvendelsen af ejendommen kan reguleres ved lov, i det omfang det er nødvendigt af hensyn til almenvellet.	neutral
Det er en klassisk diskussion, om det ene eller det andet giver mest udbytte i form af et øget uddannelsesniveau, og i Danmark har modsætningerne været eksemplificeret med den sorte skole på den ene side og Grundtvig og Kold på den anden.	neutral
Arbejdet ledes og koordineres af WSPA i samarbejde med regeringen i Bangladesh.	neutral
10) Valg af revisor og en revisorsuppleant.	neutral
4. mar 07:47, Lagt på nettet af Fredericia Avisen Politiet stoppede mandag aften kl. 18.40 en bilist på Søndermarksvej i Fredericia.	negativ
11.7 bedellium se "ordforklaringer" 12.10 Spedalskhed = uhyre smitsom og dødelig sygdom, kendes på hvide pletter i huden, sygdomstegn medførte udstødelse eller stening.	negativ
Abba tølter bare nemt derud af.	positiv
18.43: Hunnen tilbage med en mus – fodring af de meget sultne unger. 18.47: Tre unger slås om en stump pels. 18.53: Hunnen tilbage uden foder.	neutral
Publiceret: 02. Februar 2011 10:37 Casper og Iben sælger huset Efter at have boet blot to år i Værløse nord for København, er kendisparret Casper Christensen og Iben Hjejle på udkig efter et nyt hjem.	neutral
Anders Lindegaard var syg og helt ude af United-truppen.	negativ
Allerede nu kan vi løfte sløret for nogle af de mange spændende programpunkter.	positiv
Åndsfrihed i dette årti giver udfordringer, når det skal praktiseres.	negativ
7. Tag buddingen ud af formen.	neutral
28.05.2012 på 18:22 Tusind tak for dine søde ord og pæne kompliment – jeg er ikke fotograf, nej, men nyder at lege med fotograferingen.	positiv
10. april 2012 d. 17:35 - (0) 10. april 2012 d. 17:35 - (0) Det ville være super lækkert i disse stramme tider!	positiv
91. Det skal dog bemærkes, at der har været rejst tvivl om, hvorvidt de omtalte bestemmelser om bindende videresalgspriser og ensartede landsdækkende retningslinjer er i overensstemmelse med EU´s konkurrenceregler.	negativ
Anden periode fra vinterferie til påske.	neutral
Afslutningsvis taler forfatteren - set fra medarbejderperspektivet - at det fodslag, den socialisering, der tales om i bogen, lærevilligheden har en pris.	neutral
Alle, der har lyst til en guidet tur, skal blot henvende sig til en af de fire guidebaser, der er markeret med gule bannere.	positiv
Åndbart materiale SLAM Force 2 salopette - lysgrå Bukserne er lavet af åndbart med stærk SLAM Force 2 salopette - mørk grå Bukserne er lavet af SLAM Force 2 salopette - Rød Bukserne er lavet af åndbart med TP1 Opsprey jacket.	neutral
Men i dag kan mænd altså være lige så hysteriske som kvinder, ligesom ghettoer godt kan være noget andet end et område man tvinger jøder til at bo i ;) # 30. oktober 2010 kl. 16:23 Undskyld mig men det er altså noget sludder.	negativ
Der er også nye regler som vedrører omdeling af lokalpost, for eksempel lokalblade.	neutral
12. Dec 2008 - MSI har lanceret en ny VR603 med en 15.4 tommer LCD skærm.	positiv
Af klummen fremgår blandt andet, hvem der har taget magten hvor, og hvorledes ministeriets opgaver kan fordeles.	neutral
Der skal både laves en buslomme på Lundvej, være nye tilkørselsveje til Campus og altså en cykelsti på den del af Frisvadvej, som ikke har en cykelsti i dag, siger Anja Bæk.	neutral
Afskåret areal af matr. nr. 1u Torup By, Sunds eksproprieres.	neutral
3 beboere fra Sundhedscentret og beskyttede boliger. 2 pensionister fra byen (som benytter Cafeen)	neutral
Arbejdet var et tæt samarbejde mellem de tre ph.	neutral
Nu kan jeg ikke tale om alle offentlige arbejdspladser, kun dem, jeg har været tilknyttet på den ene eller den anden måde.	neutral
Alle modellerne er udført i stærke materialer, og passer derfor perfekt til den flittige bruger, der bruger sin HTC One mini mange timer hver eneste dag.	positiv
4. Canon EF 180MM 3,5L USM MACRO Dansk manual 11.799,00 DKK + fragt & gebyr Telemakro med en største forstørrelse på 1x.	neutral
Andre projekter fra Esben Meyer Indgangen er placeret centralt og fungerer samtidig som fordelingsgang.	neutral
Fra Nord til Syd, fra Danmark til Tyskland, fra fortid til nutid og fra Sønderborg til Tinglev.	neutral
Alle over 12 år er velkommen!	positiv
Affaldet bliver findelt, så det let kan transporteres i kloakken.	positiv
11. Tag blitzen ud af hvalpens mund og kast den fra dig.	neutral
Aftenen fløj afsted og var lige nøjagtig som vi havde håbet på.	positiv
Aldrig har jeg set et hold brænde så mange store chancer.	negativ
Andre Agassi, Steffi Graff, Williams- søstrene er gode eksempler fra tennisverdenen.	positiv
3. Backuppen skal have en anden fysisk placering i tilfælde af brand eller tyveri.	neutral
5) - Tørreskab/-rum til tøj og udstyr.	neutral
3 ting der påvirker nervesystemet: Hvis man ikke bruger en sti, vokser den til og det bliver besværligt at gå på den.	neutral
Animeret Gif bruges som banner reklamer, som animerede knapper eller som små animerede figurer.	neutral
Anbefalingerne er også en metode som Vordingborg Kommune fremover kan bruge til at sikre kulturarvsarbejdet i planlægningen.	positiv
300 timers reglen blev indført for at fremme det økonomiske incitament for ægtepar, der modtager kontanthjælp på de høje satser, til at søge ordinær beskæftigelse og bringe sig ud af offentlig forsørgelse.	neutral
Hvis man til den tid ikke kan sælge den til en højere pris end 1 mio. kr., og dette beløb er inkl. moms, betyder det så, at man skal afregne 200.000 kroner til Skat?	neutral
Anden fotografering blevet påbegyndt i sommeren 2002, og i de følgende år har man fortsat arbejdet.	neutral
3. D Batterier Alkaline til trådløs vagthund og Gø Fri 5. Adapter til Mega Gø Fri Woof Woof med 7 meter ledning Horser "Power Pack" batteridrevet hesteklipper IHKPP180W, ekstrem lav vægt, kun 900 gram.	neutral
15. Jobtræning og uddannelse - lov om aktiv arbejdsmarkedspolitik Hvis borgeren er kommet i jobtræning, sker det til overenskomstmæssig løn eller den sædvanligt gældende løn for tilsvarende arbejde (lov om aktiv arbejdsmarkedspolitik).	neutral
2: En rørovn med kontrolleret temperatur forsynet med en slædeskinne og en computerstyret skubbemekanisme, som kunne flytte reagensglasset ud af ovnen med en hastighed på 5 mm/time.	neutral
Alligevel er to tidligere korrespondenter i USA med indgående kendskab til amerikanske forhold ikke i tvivl om hvilken sang, de vælger til at karakterisere situationen.	neutral
Aftaler om køb uden om foreningen er ugyldige. 21. Hvis der er el indlagt i huset, skal sælger informere elselskabet om overdragelsen.	neutral
Andet er der ikke at sige end, kom igen Kasper. ( prøv bazookaen næste gang).	neutral
Åh nej - der blev vist lige skabt et behov der..	negativ
Altså jeg ved post betyder efter..	neutral
Af egen erfaring ved jeg, hvor destruktivt og opslidende det er.	negativ
Alligevel var der forskelle på undersøgte strækninger hvilket formentlig alene afspejler forskelle i randzonen.	neutral
22. januar 2014 at 9:39 Kære Lotte, jeg har sendt dig en mail :-) Knus tilbage til dig!	positiv
Altså: Vi skal have flere penge, så hele budgettet ikke skal gå til vedligehold af bygninger.	neutral
Af og til, i redt spredt orden, lykkedes det de dygtigste skytter at opnå træfning i figurer på maksimalafstanden 200 meter, altså ikke en regelmæssig, målbar træfning, men så’n ”af og til”.	positiv
Arbejdet udføres i henhold til datablad.	neutral
Åbningssiden » Sekundærlitteratur » Breve » Georg Brandes » Georg Brandes til Henrik Pontoppidan 17. jul 1899 Georg Brandes til Henrik Pontoppidan Nu ligger De vist i Sand og Sol og frisk Luft og har det godt.	neutral
"ÅÅååhh hvor passer vi godt sammen jeg kan mærke dig hele vejen op til bunden..	positiv
1. Den bedste og mest økonomiske måde at bevare Nordkysten på er ved strandfodring.	positiv
Alle virksomheder, private og offentlige institutioner mv. er omfattet af den kommunale indsamlingsordning for farligt affald og selv ansvarlige for håndtering, sortering og opbevaring.	neutral
Ai betyder harmoni, kærlighed og venskab.	positiv
Publiceret: 28. August 2010 10:00 Målløst da Rishøj mødte LFA Sent lørdag eftermiddag løb 2. Divisionsklubberne fra Rishøj BK og LFA ind på kunststofbanen på Køge Stadion til en af vinterens lange række af..	negativ
2 fribilletter til 'Angels' Share', 1 Route Irish DVD samt en flot gavepakke fra Mikkeler.	neutral
3.g'ernes revy På 3.g'ernes sidste undervisningsdag opfører de en revy over åretder gik og over deres 3 år på Rødovre Gymnasium.	neutral
Har du set denne dankort-bandit?	negativ
Han var til stede under kampen, der blev spillet på banerne ved Nordhallen, og er rystet over det, han og Skælskør-spillerne oplevede.	negativ
9. november 2009 d. 11:20 - (0) Det ser super flot ud!	positiv
1. To af Zappa-drengene opgav skuespillet Filmen “Zappa” er i forbindelse med teaterstykke atter aktuel – hvordan gik det skuespillerne fra 1983?..	neutral
Rosenholm Slotspark stynes af Hede Danmark Fodbolden i Lystrup får CO2 optimalt klubhus For 31 år siden blev Farum Bytorv opført.	neutral
9. februar 2013 kl. 23:43 Jeg har aldrig smagt noget direkte klamt is… Men der er nogle slags is, som jeg bare ikke bryder mig om – f.eks chokoladeis… Skriv et svar til charlotte bøgvad Annuller svar Din e-mail-adresse vil ikke blive offentliggjort.	negativ
12-årige Mohammed al-Durra blev kendt over hele verden, da han for rullende kamera gemte sig sammen med sin far bag en cementblok, mens israelerne beskyder dem.	negativ
Ændringer der relaterer til Gunnarstranda Denne specialside viser de seneste ændringer på de sider der henvises til.	neutral
Allingåbro Motor Festival forbeholder sig retten til at bruge de indsendte billeder på hjemmesiden, og facebooksiden.	neutral
Alle kender jo treskærmslamperne, koglerne og PH5, men her får man virkelig mulighed for at følge udviklingen i PH’s arbejde, fortæller Axel Johnsen, der er udstillingsleder på museet.	neutral
Indtil da vil flyvestationen blive afpatruljeret af militær bevæbnede vagter," siger Jan Gert Andersen, Driftsafdelingschef, fra Forsvarets Bygnings og Etablissementstjeneste i Hjørring.	neutral
Alt i alt havde vi en god lejr med vejr lige fra regn til sol.	positiv
Alexandra fra Visage er mester for behandlingen, der kræver lidt mere end almindelig fingerfærdighed og tålmodighed.	positiv
4. Et levende og aktivt lokalt demokrati kræver også ressourcer, hvad angår frivillig borgerdeltagelse og mødelokaliteter.	neutral
Andre indskud forrentes med mindst samme rentesats, som kan opnås ved indskud i banker og sparekasser.	neutral
Alt i alt et eksempel på en smuk renovering og kombination mellem gammelt og nyt byggeri.	positiv
3 er bare pisse fedt, elsker også hvordan de har fået deezer til danmark. og så er jeg vild med friendtones.	positiv
Alle priser er eksklusiv moms Helt nye Alliance Multiuse 550 industridæk med stålbælter.	neutral
Af aftalen fremgår det også, at der ikke er belæg for at mistænke ledere eller andre ansatte for at samarbejde med pædofilringe, samt at Somalisk Forum fremover vil respektere anklagemyndighedens afgørelser i sådanne sager.	negativ
Dødulykken sker kun to dage efter, at en motorcyklist trafikdræbte en ældre mand på Rågeleje Strandvej - kun 7-8 km fra aftenens dødsulykke.	negativ
Og pornoficeringen af det offentlige rum eller kroppes totale markedsgørelse er ikke ligestilling, men en kommerciel udnyttelse af kønnet.	negativ
Hele kapitalismens vækstparadigme understøtter denne afhængighed, og derfor er det nærmest umuligt at vende skuden inden for det herskende paradigme.	negativ
Alt i alt en kon­fus per­for­mance fra en ellers habil og dygtig kun­st­ner.	negativ
Ankestyrelsen lagde ved denne afgørelse vægt på, at der ikke havde været tale om ansættelse i internationale organisationer, som den danske stat er medlem af, eller beskæftigelse i forbindelse med ansættelse ved internationale projekter.	neutral
Adskillelsen gør, at der kun lige er plads til en taske 35x35x70 cm Min håndbagage måtte jeg have foran passaggersædet som det ses på billedet ovenfor.	negativ
9. Jeg er bredbåndskunde hos TDC og kan lige pludselig ikke modtage mail?	negativ
Spørgsmålet er, om de vil betale mere for at beholde ordningen.	neutral
Alternate Page for Screenreader Users KUBIS » LibGuides @ KUBIS » Tværfaglig »E-bøger E-bøger Tags: apps, e-bøger Download til iPads, iPhones og Androids Fra EBL kan du downloade hele e-bøger til tablets og smartphones.	neutral
Alt efter smag kan det vel indimellem være underholdende og mere eller mindre elegant i sin fremtoning, men nogen blot tilnærmelsesvis værdi udover et muligt kortvarigt grin indeholder forestillingen ikke.	negativ
8. Derefter går turen videre til næste minigruppe, som har 45 sekunder til at gætte så mange som muligt.	neutral
Flammerne havde allerede så godt fat, da indsatsleder Leif B. Johansen ankom lige efter kl. 14, hvor ilden gået igennem taget.	negativ
Alt det udenom var strippet væk, og kun det væsentligste stod klart og tydeligt tilbage.	positiv
Heriblandt en erklæret større åbenhed.	positiv
9. Preload image, betyder at billedet indlæses samtidig med at websiden åbnes, så skal brugerne ikke vente på at billedet kommer til syne når de laver Swap image funktionen.	neutral
Alle institutioner, både skolekantiner og børnehaver, vil i fremtiden få ansvaret for at give børn og elever et nærende måltid mad.	neutral
6. Den varme tærte drysses ganske let med flormelis og stilles til afkøling. 7. Kagen serveres kold, i Italien uden tilbehør, men den er med succes blevet serveret i DK med iskold flødeskum.	neutral
1) Hvordan bliver jeg kunde hos Lebara Mobile?	neutral
Alligevel var der grund til at glæde sig til aftenens træning.	positiv
Lad os huske dem som 'The Bad Boys' med den frække, provokerende attitude.	positiv
Allerede den 28. marts 1690 havde Knuth skøde på Lille Troldmølle.	neutral
Alle og enhver er altså med til at forme det samfund, vi lever i. Enhver kan sige noget, som kan bruges af andre.	positiv
Allerede inden vorten nåede målet, var min plirrende tunge gået på arbejde og ramte snart den lille stive knob.	neutral
Almen praksis og sundhedsvæsenet som helhed skal løbende moderniseres.	neutral
Aktive grupper som opsøger og deltager spillet og derfor skaber spil er en god gruppe.	positiv
Alt taget i betragtning er selve ferien billig, da der medfølger så mange ting.	positiv
30-08-1999 Biscayen Forventer at ankomme til Porto i Portugal omkring 03-08-1999, hvis alt forløber vel.	neutral
Generelt vil hun kalde det »dårlig forvaltningsskik«, hvis kommunen har afvist at oplyse en borger om en afgørelse.	negativ
09-10 sæson Spa Francorchamps S2000 Vinter Cup 10. januar 2011, af Ian Andersen Kvalifikation: Det gik nogenlunde, men bilen føltes god.	positiv
1. Gennemførelse af uddannelsen i to dele: Uddannelsesstedet kan vælge, at gennemføre Funktionsuddannelse, Indsats i to dele med prøve efter 1. del og afsluttende eksamen efter 2. del.	neutral
Aftalen indebærer blandt andet, at universitetsområdet tilføres 682 mio.kr. til styrkelse af forskeruddannelsen, at den strategiske forskning tilføres 1.231 mio.	neutral
2. Freerolls er også multi poker turneringer – Sådan gør du i praksis!	neutral
7. Alle ture skal skrives i journalen inden turens start.	neutral
Af udvalget må der vælges 2 slags stege, - hvis ekstra steg ønskes koster det kr 20,- pr. person.	neutral
Alligevel fortæller han, at han aldrig har været så meget oppe i det røde felt som på denne film.	neutral
1. præmie (og titlen som Nordjysk Naturtalent): Sabina David Ruban, 3.y.	positiv
Aftalen var så, at den karl, der boede nærmest ved en af pigerne, skulle følge hende hjem og være sikker på, at hun kom hjem.	neutral
